1,1,1,1,1
1,2,4,2,1
1,3,5,3,1
1,2,4,2,1
1,1,1,1,1
