1,4,3,4,1
1,2,4,2,1
3,3,5,3,3
1,2,4,2,1
1,4,3,4,5
